EA ./assets/colorstone.xpm          
SO      ./assets/wood.xpm   
WE              ./assets/greystone.xpm

NO./assets/purplestone.xpm

F     55,    55,   55
C  44, 23  ,  41

 1110111
1101N1001
111111111
