EA ./assets/colorstone.xpm
SO ./assets/wood.xpm
WE ./assets/greystone.xpm
NO ./assets/purplestone.xpm

F 255,255,255


C 0,0,0


111111111111111 11111
100000000000001 11001 
1000000000N0001 11111 
100000000000001
100111111111001
1001       1001
1001       1001
1001111    1001
100000111110001
100000000000001
111111110011111
       1111                     
111111111111111
100000000000001
100000000000001
100111111111001
1001       1001
1001       1001
1001111    1001
100000111110001
100000000000001
111111110011111
       1111   



































