EA ./assets/colorstone.xpm
SO ./assets/wood.xpm
WE ./assets/greystone.xpm
NO ./assets/purplestone.xpm

F 255,255,255


C 0,0,0

111111
1000001
10N001
1000001
111111




































