EA ./assets/colorstone.xpm
SO ./assets/wood.xpm
WE ./assets/greystone.xpm
NO ./assets/purplestone.xpm

C 72,61,139
F 72,61,139


1111111111111111
1000000000000001
1000000000000001
1000000000000001
1000000000000001
1000000000000001
1000000000000001
1000000000000001
1000000000000001
10000000N0000001
1000000000000001
1000000000000001
1111111111111111