



EA ./assets/colorstone.xpm
WE			./assets/greystone.xpm

C               0,1,255   

            F       255,127,64          

NO ./assets/purplestone.xpm



	SO ./assets/wood.xpm	
11111
10001
10N01
10001
11111



