SO ./assets/wood.xpm
NO ./assets/purplestone.xpm   

F 120,80,10             
WE ./assets/greystone.xpm
C 0,80,160                  




                EA ./assets/colorstone.xpm



111111111111111
10000000000111
100000000000001
11110011111111
    101
    101
    101
    101
11111001111111
100000000000001
100000000000001
1000000E000001
100000000000001
100000000000001
100000000000001
100000000000001
100000000000001
100000000000001
111111111111111




