
EA ./pics/colorstone.xpm
SO ./pics/wood.xpm
WE ./pics/greystone.xpm
NO ./pics/purplestone.xpm

F 255,f6,0
C 0,1,255





11111
10W01
10001
11111



