EA     ./assets/../assets/colorstone.xpm
 NO ./assets/purplestone.xpm        

F 255,255,255        
SO                          ./assets/wood.xpm




                                                 WE ./assets/greystone.xpm          
                     C 0           ,0  ,  0      
111111111111111
1000000000000W1
100000000000001
100111111111001
1001       1001
1001       1001
1001111    1001
100000111110001
100000000000001
111111110011111
       1111




































